###############################
#  * *2       *  *b * *      *#
# # #b# #*# # #f# # # #b# #*# #
#    s * *** **      *    **  #
# #f# # # # # # #b# # # # # #*#
#          *     **  1      **#
# # #*# #b# # # #*#*#*#*# # # #
#   *    2   *   * *x*b       #
# # # # #*# # # # # # #*# #*# #
#   *b**         *b  4        #
# # # # # # # # # #*# #b# # #*#
#   * *   *    3   b          #
###############################




