###############################
#      ** *     *   *  * * *   #
# # #b#*# # #*#*# # #b#*#*#*# #
#   *     *f*  *  4   *   * * #
# # # # # #*# # #*#*# # # # #*#
#b        *  **  *  *   4     #
# # #s# # # # # # #*# #*# # # #
#*  *      *  *b2    *        #
# # #b# #b# # # #*#*# # #b#*# #
#*    **  *    **x*      3    #
# #*# # # # # # #*# # # # #*# #
#    *b     **  *  * 2        #
###############################
