###############################
#             4*       4  *   #
# # # #b# # #*#*# # # #*# #*# #
#    4    b *  *         4* * #
# # # # # #*# # #*#*# # # # #*#
#b   f 4      *  *  *     4   #
# # # # # # # # # #*# #*# # # #
#*  b  4   *  *      *   4    #
# # # # #*# # # #*#*# # # # # #
#*    b*  *    4  *      4    #
# #*# # # # # # # # # # # # # #
#      4    *      *     4    #
###############################
